1111111111111111111111
1E1CPC0100000010100111
10110000001110C0111111
1C00001C00000C0010C111
101C10001111011C0C0001
1110C01000000000101011
1C0001000C0111001C1011
1111111111111111111111