1111111111111111111
101000001000000C001
100000C110001111101
11110100C0001111101
10C0010010P10010101
1111111101110000001
1111111000000C11111
110100101100CE11111
110100101100CE11111
1111111111111111111