11111111111111111111111111111111111111111
10000000001111111110000000111000000111111
10000000000000000000000000011111111000011
10000000111111111000000000000011000001111
10000000000011111111100000001111111111111
10000000000000000000000000011110000001111
10001111111110000000000000000110000000111
10000000000000000000000000011111111111111
10000001111111110000000001100001111011111
10000000000000000111111111000111111111111
10000111111110000000000000011111111111111
10000011111111100000000000000011111111111
10000000000000000000000000011111111111111
10001111111110000000000000000001111111111
10000000000000000000000000011111111111111
10000011111111100000000000011111111111111
10000000000000000000000000011111100000111
10000000000000000000000000011111111111111
10000000000000000000000000011111100001111
10000000000011111111100000011111111111111
10001111111110000000000000000001111111111
10000000000000000000000000011111111111111
10000011111111100000000000111111110000111
10000000000000000000EPC0P0011111111001111
11111111111111111111111111111111111111111