111111111111111111111111111
1000001C1111111100111000011
101001101111111100000011111
101100001111111100011000011
10C00P0000C0000000011011111
111110000111111100000011111
1C0001C01111C00100111100001
111000011111110100011100011
1C0000000000000100101101111
1C0001C01111C00100111100001
1110000111111101000C1100011
1C00001111100C01001E1100111
111111111111111111111111111