1111111111111111111111111111111111111111111
1P000C0000000111111110000000000000C00000001
1000011111110000000000111111111110001111111
1100000011111111111111110000000000000000001
1111110000000001111111000001101111111100001
111111111111110000000001111111111C000000E11
1111111111111111111111111111111111111111111