11111111111111111111111
1000001C111111110011111
10100110111111110011111
10110000111111110001111
10C00P0000C000000001101
11111000011111110001111
1C0001C01111C0010011111
11100001111111010001111
1C000000000000010010111
1C0001C01111C0010011111
1110000111111101000C111
1C00001111100C01001E111
11111111111111111111111