11111111111111111111111
1PE0001C111111110011111
10000110111111110011111
11110000111111110001111
11C0000000C000000001101
11111000011111110001111
1C0001C01111C0010011111
11100001111111010001111
1C000000000000010010111
1C0001C01111C0010011111
11100001111111010000111
1C00001111100C01001C111
11111111111111111111111