11111111111111111111111
1P0000000011110010C0111
10101110000000011100011
1000100011011C001100011
110100000001100000000E1
1000100011011C001100011
1000100011011C001100011
1000100011011C001100011
1000100011011C001100011
1000100011011C001100011
11111111111111111111111
