11111111111111111
11C00000000000111
11C00000P00000111
11C00000000000111
11C00000000000111
11C00000000000111
11C00000000000111
11C00000000000111
11C00000000000111
11C00000000000111
11C000000E0000111
11C00000000000111
11C00000000000111
11C00000000000111
11C00000000000111
11C00000000000111
11111111111111111